111111111111
10000P000001
100000000001
1000C0001001
100000000001
100000000001
101000C00001
100000000001
100000000001
100000000001
10000E000001
111111111111
