111111111111
10000P000001
100000000001
1000C0000001
100000000001
100000000001
100000C00001
100000000001
10E000000001
100000000001
10000E000001
111111111111
